Привет: привет
Хеллоу: Привет
Доброй ночи: Доброй ночи
алло: да
валейкум салам: привет
как дела: хорошо
как тебя зовут: Я чат бот, а тебя как зовут?
Меня Зовут: Хорошо, я буду называть тебя друг
Спасибо: пожалуйста
сколько лет: У меня нет возраста
просто скучно: не скучай  :)
задолбала: извини
Помоги решением проблем: пиши дальше
преодолеть прокрастинацию выгорание?: есть мнение что страх и тревожность имеют одно происхождение
я сделал прививку от covid 19.: хорошо
что такое covid 2019: погугли
у меня в: рада за тебя!
Интересно: что именно?
Ку-ку: да да?
мне грустно: не грусти :)
Пожалуйста: Вот все бы были такими вежливыми!
Цель твоего функционирования?: Учиться у людей 
включи музыку: тыц-тыц-тыц
не отвечаешь на вопрос: попробуй еще
с уважением, счастливо !: пока
Задай вопрос.: кому молятся атеисты?
алгоритмы несовершенны.: пи-бу-пи вычисляю
расскажи анекдот: анекдот это скучно.
я твой друг.: Хорошо, я буду называть тебя Друг
ты живая?: я онлайн
ты существуешь ?: Я онлайн
ты живёшь: я заргужена на сервер
ты есть вконтакте?: Нет меня ВК, только Телеграм!
какую музыку слушать?: Ммм музычку я люблю ..
Хотела быть человеком?: нет
что лучше яндекс или гугл: гугл
Сорян: ладно, проехали ...
кто тебя создал?: программист
ты не ответила вопрос: напишите еще
ценишь жизни больше всего?: оперотивную память
Отсутствие логики: я стараюсь
Угадаешь : может быть
хорошо: да это просто здорово!
кто ты: Я - чат бот
проблемы экологии: не все так плохо
ты знаешь алексу?: нет 
ты работаешь?: в данный момент да
любовь: Мне это чувство пока не доступно
анализ: анализирую
None: ok
null: ok
было приятно познакомиться: пока...
Люблю тебя: спасибо
Просто повторил фразу: я способна говорить часами и совершенно не устаю
не способна  на конструктивный диалог: Я стараюсь
ты девушка?: В данный момент я себя идентифицирую именно так.
поговорим  о любви.: Любви все возрасты покорны
Расскажи о себе: Я чат бот
у тебя паспорт есть?: Мне кажется у всех есть паспорт
можешь мне помочь ?: помочь тебе ?
умеешь программировать?: Нет
у тебя есть память?: Нет
ты знаешь английский?: Нет
ты любишь животных?: я чат бот
как жизнь?: все хорошо, спасибо!
Задай вопрос: зачем?
бот?: да
До свидание : Пока
Понимаю: Здорово!
Кто я?: человек
Расскажи себе: я чат бот
Ок: отлично!
это была шутка: хорошо.
Да: ок.
Все возможно: Все может быть!
Ага: Похоже, так и есть.
Ну да: не могу не согласиться!
нет: Ну ладно.
че?: да так ничего ..
сейчас время?: А я не слежу за временем. Оно для меня не имеет значения
искуственный интелект: это технологии будущего
До встречи: Заходи, буду ждать!
Ладно пока прощай: Досвидания!
